##########
#--------#
#--------#
#----@---#
##########