######
#----#
#.$$-#
#-.@-#
#----#
######
