#####
#---#
#---#
#---#
#---#
#--@#
#---#
#---#
#---#
#####
