######
#-.--#
#-$.-#
#-$--#
#-@--#
######
