######
#-**-#
#-**-#
#-*.$@
#----#
######
